###############################################################################
##      ##      ##      ##      ##      ##      ##      ##      ##     ##      
#   ######   ###     ####    ##  ########        ### ####    #######    #######
##    ######  ####### ##### ##      ##      ######   #  ##       #             
 ###   # # #    ### #  ##   ##  #####      ##    #### ######    ##      #######
 # #   # # #    # # #   ##   ####   #######    ###         ###   ##   ####     
   ##      ######   ###  ### ##   ####       ###    ####     #####   ########  
    
  
 
